//MAP CONVERTED BY dmm2tgm.py THIS HEADER COMMENT PREVENTS RECONVERSION, DO NOT REMOVE
"aa" = (
/obj/effect/landmark/start/f13/dfs_advisor,
/turf/open/indestructible/sound/pool,
/area/admin)
"aB" = (
/obj/machinery/light/floor,
/turf/open/indestructible/ground/bl/outside/grass_standard/meadow,
/area/f13/wasteland)
"aL" = (
/obj/machinery/autolathe/ammo/army,
/turf/open/indestructible/ground/bl/outside/stone,
/area/centcom/vip)
"bj" = (
/obj/item/gun/ballistic/fatman,
/turf/open/indestructible/ground/bl/outside/stone,
/area/centcom/vip)
"bR" = (
/obj/item/ammo_casing/caseless/fatman,
/turf/open/indestructible/ground/bl/outside/stone,
/area/centcom/vip)
"cB" = (
/obj/machinery/autolathe/secure,
/turf/open/indestructible/ground/bl/outside/stone,
/area/centcom/vip)
"cL" = (
/obj/machinery/autolathe,
/turf/open/indestructible/ground/bl/outside/stone,
/area/centcom/vip)
"ds" = (
/obj/structure/obstacle/barbedwire/end{
	dir = 4
	},
/turf/open/indestructible/ground/bl/outside/stone,
/area/centcom/vip)
"dJ" = (
/turf/open/indestructible/ground/bl/outside/grass_standard/meadow,
/area/f13/wasteland)
"es" = (
/obj/effect/landmark/start/f13/gmb_commander,
/turf/open/indestructible/sound/pool,
/area/admin)
"ew" = (
/obj/effect/landmark/start/f13/hilltop_settler,
/turf/open/indestructible/sound/pool,
/area/admin)
"eF" = (
/obj/machinery/autolathe/constructionlathe,
/turf/open/indestructible/ground/bl/outside/stone,
/area/centcom/vip)
"eO" = (
/obj/item/seeds/bl/milkweed,
/turf/open/indestructible/ground/bl/mud,
/area/f13/admeme)
"fH" = (
/turf/open/indestructible/sound/pool,
/area/admin)
"fN" = (
/obj/item/seeds/bl/licorice,
/turf/open/indestructible/ground/bl/mud,
/area/f13/admeme)
"gI" = (
/obj/effect/landmark/start/f13/vaultengineer,
/turf/open/indestructible/sound/pool,
/area/admin)
"gM" = (
/obj/structure/shieldwall/large/active,
/turf/open/indestructible/ground/bl/outside/stone,
/area/centcom/vip)
"gX" = (
/obj/structure/billboard/vb/gmtammo,
/turf/open/indestructible/sound/pool,
/area/admin)
"hd" = (
/obj/structure/shieldwall/standard/lethal,
/turf/open/indestructible/ground/bl/outside/stone,
/area/centcom/vip)
"iI" = (
/turf/open/liquid/water,
/area/f13/wasteland/bl/lbj)
"iS" = (
/turf/open/indestructible/ground/bl/outside/stone,
/area/centcom/vip)
"ju" = (
/obj/machinery/autolathe/ammo/unlocked,
/turf/open/indestructible/ground/bl/outside/stone,
/area/centcom/vip)
"la" = (
/obj/effect/landmark/start/f13/secchief,
/turf/open/indestructible/sound/pool,
/area/admin)
"nw" = (
/obj/structure/billboard/vb/glazedholes,
/turf/open/indestructible/sound/pool,
/area/admin)
"qA" = (
/obj/effect/landmark/start/f13/gmb_volunteer,
/turf/open/indestructible/sound/pool,
/area/admin)
"rk" = (
/obj/item/gun/magic/wand/death/debug,
/turf/open/indestructible/ground/bl/outside/stone,
/area/centcom/vip)
"rH" = (
/obj/machinery/manned_turret/m2,
/turf/open/indestructible/ground/bl/outside/stone,
/area/centcom/vip)
"rR" = (
/turf/open/liquid/water/deep,
/area/f13/wasteland/bl/lbj)
"sd" = (
/obj/effect/landmark/start/f13/dfs_regular,
/turf/open/indestructible/sound/pool,
/area/admin)
"tv" = (
/obj/item/storage/box/disks_plantgene,
/turf/open/indestructible/ground/bl/outside/stone,
/area/centcom/vip)
"tJ" = (
/obj/machinery/chem_master/advanced,
/turf/open/indestructible/ground/bl/outside/stone,
/area/centcom/vip)
"uM" = (
/turf/open/indestructible/ground/bl/mud,
/area/f13/admeme)
"uX" = (
/obj/effect/landmark/start/f13/wastelander,
/turf/open/indestructible/sound/pool,
/area/admin)
"vO" = (
/turf/open/liquid/water/scum_aboveground/north,
/area/f13/wasteland/bl/lbj)
"vW" = (
/obj/structure/mineral_door/transparent,
/turf/open/indestructible/ground/bl/outside/stone,
/area/centcom/vip)
"wq" = (
/obj/machinery/hydroponics/constructable{
	self_sustaining = 1
	},
/turf/open/indestructible/ground/bl/outside/stone,
/area/centcom/vip)
"wI" = (
/obj/machinery/base_dispenser/enclave,
/turf/open/indestructible/ground/bl/outside/stone,
/area/centcom/vip)
"wT" = (
/obj/effect/landmark/start/f13/vaultscientist,
/turf/open/indestructible/sound/pool,
/area/admin)
"xb" = (
/obj/machinery/base_dispenser/ammo,
/turf/open/indestructible/ground/bl/outside/stone,
/area/centcom/vip)
"xC" = (
/obj/structure/billboard/vb/lovemybuns,
/turf/open/indestructible/sound/pool,
/area/admin)
"yx" = (
/obj/effect/landmark/start/f13/lbj_foreman,
/turf/open/indestructible/sound/pool,
/area/admin)
"yE" = (
/obj/effect/landmark/start/f13/dfs_grunt,
/turf/open/indestructible/sound/pool,
/area/admin)
"yH" = (
/obj/effect/landmark/start/f13/vaultdoctor,
/turf/open/indestructible/sound/pool,
/area/admin)
"zQ" = (
/obj/item/melee/bokken/debug,
/turf/open/indestructible/ground/bl/outside/gravel,
/area/f13/wasteland/bl/lbj)
"Ap" = (
/obj/effect/landmark/start/f13/gmb_militia,
/turf/open/indestructible/sound/pool,
/area/admin)
"AL" = (
/turf/closed/indestructible/f13/matrix,
/area/centcom/vip)
"AX" = (
/turf/open/liquid/water/scum/west,
/area/f13/wasteland/bl/lbj)
"Be" = (
/obj/machinery/chem_dispenser/fullupgrade,
/turf/open/indestructible/ground/bl/outside/stone,
/area/centcom/vip)
"BL" = (
/turf/open/liquid/water/scum/north,
/area/f13/wasteland/bl/lbj)
"Cj" = (
/obj/effect/landmark/start/f13/dfs_agent,
/turf/open/indestructible/sound/pool,
/area/admin)
"CO" = (
/obj/effect/landmark/latejoin,
/turf/open/indestructible/sound/pool,
/area/admin)
"Dg" = (
/obj/effect/landmark/start/f13/overseer,
/turf/open/indestructible/sound/pool,
/area/admin)
"DP" = (
/obj/effect/landmark/start/f13/vaultrobot,
/turf/open/indestructible/sound/pool,
/area/admin)
"Ea" = (
/obj/machinery/shield_switch,
/turf/open/indestructible/ground/bl/outside/stone,
/area/centcom/vip)
"EA" = (
/obj/item/seeds/bl/yarrow,
/turf/open/indestructible/ground/bl/mud,
/area/f13/admeme)
"ET" = (
/obj/structure/billboard/vb/vaulttec,
/turf/open/indestructible/sound/pool,
/area/admin)
"Fk" = (
/obj/structure/billboard/vb/oldantucker,
/turf/open/indestructible/sound/pool,
/area/admin)
"FE" = (
/obj/item/gun/energy/arcwelder,
/turf/open/indestructible/ground/bl/outside/stone,
/area/centcom/vip)
"Gc" = (
/turf/open/indestructible/necropolis,
/area/cordon)
"Gr" = (
/turf/open/liquid/water/scum_aboveground/west,
/area/f13/wasteland/bl/lbj)
"Gw" = (
/obj/item/storage/toolbox/mechanical,
/turf/open/indestructible/ground/bl/outside/stone,
/area/centcom/vip)
"GZ" = (
/obj/structure/billboard/vb/slocumsjoe,
/turf/open/indestructible/sound/pool,
/area/admin)
"Hy" = (
/obj/machinery/light/floor,
/turf/open/indestructible/ground/bl/outside/stone,
/area/centcom/vip)
"Jb" = (
/obj/structure/obstacle/barbedwire{
	dir = 4
	},
/turf/open/indestructible/ground/bl/outside/stone,
/area/centcom/vip)
"Ku" = (
/obj/effect/landmark/start/f13/gmb_practitioner,
/turf/open/indestructible/sound/pool,
/area/admin)
"LL" = (
/obj/machinery/autolathe/ammo/unlocked_basic,
/turf/open/indestructible/ground/bl/outside/stone,
/area/centcom/vip)
"Ml" = (
/obj/structure/billboard/vb/superdupermart,
/turf/open/indestructible/sound/pool,
/area/admin)
"MQ" = (
/obj/structure/obstacle/barbedwire/end{
	dir = 8
	},
/turf/open/indestructible/ground/bl/outside/stone,
/area/centcom/vip)
"Nc" = (
/obj/item/grenade/f13/mine,
/obj/item/grenade/f13/mine,
/obj/item/grenade/f13/mine,
/obj/item/grenade/f13/mine,
/obj/item/grenade/f13/mine,
/obj/item/grenade/f13/mine,
/turf/open/indestructible/ground/bl/outside/stone,
/area/centcom/vip)
"Nm" = (
/obj/effect/landmark/start/f13/tavernkeep,
/turf/open/indestructible/sound/pool,
/area/admin)
"NA" = (
/obj/structure/shieldwall/standard_owb/active,
/turf/open/indestructible/ground/bl/outside/stone,
/area/centcom/vip)
"NP" = (
/obj/effect/landmark/start/f13/lbj_lumberjack,
/turf/open/indestructible/sound/pool,
/area/admin)
"Oe" = (
/obj/structure/anvil/debugsuper,
/obj/item/melee/smith/hammer/debug,
/turf/open/indestructible/ground/bl/outside/stone,
/area/centcom/vip)
"Ov" = (
/obj/effect/landmark/start/f13/hilltop_leadership,
/turf/open/indestructible/sound/pool,
/area/admin)
"OS" = (
/obj/effect/landmark/start/f13/hilltop_lookout,
/turf/open/indestructible/sound/pool,
/area/admin)
"Pa" = (
/obj/machinery/base_dispenser/food,
/turf/open/indestructible/ground/bl/outside/stone,
/area/centcom/vip)
"PF" = (
/obj/effect/landmark/start/f13/dfs_enforcer,
/turf/open/indestructible/sound/pool,
/area/admin)
"Qs" = (
/obj/item/seeds/bl/skullcap,
/turf/open/indestructible/ground/bl/mud,
/area/f13/admeme)
"Qy" = (
/obj/effect/landmark/start/f13/vaultdweller,
/turf/open/indestructible/sound/pool,
/area/admin)
"QO" = (
/obj/machinery/plantgenes,
/turf/open/indestructible/ground/bl/outside/stone,
/area/centcom/vip)
"Rt" = (
/turf/open/indestructible/ground/bl/outside/gravel,
/area/f13/wasteland/bl/lbj)
"RF" = (
/obj/item/gun/magic/wand/resurrection/debug,
/turf/open/indestructible/ground/bl/outside/stone,
/area/centcom/vip)
"RL" = (
/obj/structure/shieldwall/standard/stun,
/turf/open/indestructible/ground/bl/outside/stone,
/area/centcom/vip)
"RZ" = (
/obj/effect/landmark/start/f13/engchief,
/turf/open/indestructible/sound/pool,
/area/admin)
"Sy" = (
/obj/structure/billboard/vb/readmenace,
/turf/open/indestructible/sound/pool,
/area/admin)
"Tm" = (
/turf/open/liquid/water/scum/east,
/area/f13/wasteland/bl/lbj)
"Tp" = (
/obj/structure/mortar/fixed,
/turf/open/indestructible/ground/bl/outside/stone,
/area/centcom/vip)
"TG" = (
/obj/item/book/granter/trait/holy,
/turf/open/indestructible/ground/bl/outside/stone,
/area/centcom/vip)
"Vr" = (
/obj/structure/billboard/vb/ratemed,
/turf/open/indestructible/sound/pool,
/area/admin)
"Wb" = (
/turf/closed/indestructible/f13/matrix,
/area/admin)
"WU" = (
/obj/machinery/autolathe/ammo,
/turf/open/indestructible/ground/bl/outside/stone,
/area/centcom/vip)
"Xs" = (
/turf/open/liquid/water/scum_aboveground/east,
/area/f13/wasteland/bl/lbj)
"XM" = (
/turf/open/liquid/water/scum_aboveground/south,
/area/f13/wasteland/bl/lbj)
"XV" = (
/obj/effect/landmark/start/f13/vaultsecurityofficer,
/turf/open/indestructible/sound/pool,
/area/admin)
"XX" = (
/turf/open/liquid/water/scum/south,
/area/f13/wasteland/bl/lbj)
"Yn" = (
/obj/machinery/autolathe/hacked,
/turf/open/indestructible/ground/bl/outside/stone,
/area/centcom/vip)
"YF" = (
/obj/machinery/autodoc,
/turf/open/indestructible/ground/bl/outside/stone,
/area/centcom/vip)
"YN" = (
/obj/structure/closet/crate/mortar_shells,
/turf/open/indestructible/ground/bl/outside/stone,
/area/centcom/vip)
"Zn" = (
/turf/open/water/cursed_spring,
/area/f13/wasteland/bl/lbj)
"Zp" = (
/obj/machinery/porta_turret/f13,
/turf/open/indestructible/sound/pool,
/area/admin)
"Zq" = (
/obj/effect/landmark/start/f13/gmb_walker,
/turf/open/indestructible/sound/pool,
/area/admin)

(1,1,1) = {"
Wb
Wb
Wb
Wb
Wb
Wb
Wb
Wb
Wb
Wb
Wb
Wb
Wb
Wb
Wb
Wb
Wb
Wb
Wb
Wb
Wb
"}
(2,1,1) = {"
Wb
Zn
AX
Gr
Gc
Gc
Wb
Zp
Wb
nw
gX
xC
Fk
Vr
Sy
GZ
Ml
ET
Nm
CO
Wb
"}
(3,1,1) = {"
Wb
BL
XM
XX
Gc
Gc
Wb
fH
Wb
fH
fH
fH
fH
fH
fH
fH
fH
fH
yH
aa
Wb
"}
(4,1,1) = {"
Wb
vO
Tm
Xs
Hy
iS
vW
Hy
vW
iS
NA
iS
RL
iS
hd
iS
gM
Hy
Qy
Cj
Wb
"}
(5,1,1) = {"
Wb
rR
iI
iI
cL
Gw
AL
AL
AL
iS
iS
iS
Ea
iS
iS
iS
iS
iS
gI
PF
Wb
"}
(6,1,1) = {"
Wb
rR
iI
iI
WU
iS
iS
iS
iS
iS
iS
iS
QO
iS
iS
iS
iS
iS
DP
yE
Wb
"}
(7,1,1) = {"
Wb
rR
iI
iI
aL
iS
iS
Hy
iS
iS
iS
iS
tv
iS
Hy
iS
iS
iS
wT
sd
Wb
"}
(8,1,1) = {"
Wb
rR
iI
iI
ju
iS
Rt
Rt
wI
Pa
TG
iS
iS
wq
wq
wq
iS
iS
XV
RZ
Wb
"}
(9,1,1) = {"
Wb
rR
iI
iI
LL
iS
Rt
Rt
xb
ds
iS
iS
wq
fN
eO
Qs
wq
iS
uX
es
Wb
"}
(10,1,1) = {"
Wb
rR
iI
iI
eF
iS
Rt
Rt
zQ
Jb
Hy
Hy
iS
uM
uM
EA
iS
iS
fH
Ap
Wb
"}
(11,1,1) = {"
Wb
rR
iI
iI
Yn
iS
Rt
Rt
Rt
Jb
rH
Tp
FE
uM
uM
uM
bj
bR
fH
Ku
Wb
"}
(12,1,1) = {"
Wb
rR
iI
iI
cB
iS
Rt
Rt
Rt
Jb
YN
Nc
iS
uM
uM
uM
bR
bR
fH
qA
Wb
"}
(13,1,1) = {"
Wb
rR
iI
iI
iS
iS
Rt
Rt
Rt
Jb
Hy
Hy
iS
uM
uM
uM
iS
iS
fH
Zq
Wb
"}
(14,1,1) = {"
Wb
rR
iI
iI
YF
RF
Rt
Rt
Be
MQ
iS
iS
wq
uM
uM
uM
wq
iS
fH
Ov
Wb
"}
(15,1,1) = {"
Wb
rR
iI
iI
Oe
rk
Rt
Rt
tJ
iS
iS
iS
iS
wq
wq
wq
iS
iS
fH
OS
Wb
"}
(16,1,1) = {"
Wb
rR
iI
iI
dJ
dJ
dJ
aB
dJ
dJ
dJ
dJ
dJ
dJ
aB
dJ
dJ
iS
fH
ew
Wb
"}
(17,1,1) = {"
Wb
rR
iI
iI
dJ
dJ
dJ
dJ
dJ
dJ
dJ
dJ
dJ
dJ
dJ
dJ
dJ
iS
fH
yx
Wb
"}
(18,1,1) = {"
Wb
rR
iI
iI
dJ
dJ
dJ
dJ
dJ
dJ
dJ
dJ
dJ
dJ
dJ
dJ
dJ
iS
fH
NP
Wb
"}
(19,1,1) = {"
Wb
rR
iI
iI
aB
dJ
dJ
dJ
dJ
dJ
dJ
dJ
dJ
dJ
dJ
dJ
dJ
Hy
fH
Dg
Wb
"}
(20,1,1) = {"
Wb
rR
iI
iI
dJ
dJ
dJ
dJ
dJ
dJ
dJ
dJ
dJ
dJ
dJ
dJ
dJ
fH
fH
la
Wb
"}
(21,1,1) = {"
Wb
rR
iI
iI
dJ
dJ
dJ
dJ
dJ
dJ
dJ
dJ
dJ
dJ
dJ
dJ
dJ
fH
fH
fH
Wb
"}
(22,1,1) = {"
Wb
Wb
Wb
Wb
Wb
Wb
Wb
Wb
Wb
Wb
Wb
Wb
Wb
Wb
Wb
Wb
Wb
Wb
Wb
Wb
Wb
"}
