//MAP CONVERTED BY dmm2tgm.py THIS HEADER COMMENT PREVENTS RECONVERSION, DO NOT REMOVE
"aa" = (
/obj/effect/landmark/start/f13/dfs_advisor,
/turf/open/indestructible,
/area/f13/village)
"aB" = (
/obj/machinery/light/floor,
/turf/open/indestructible/ground/bl/outside/grass_standard/meadow,
/area/f13/wasteland)
"aL" = (
/obj/machinery/autolathe/ammo/army,
/turf/open/indestructible,
/area/f13/wasteland)
"bj" = (
/obj/item/gun/ballistic/fatman,
/turf/open/indestructible,
/area/f13/wasteland)
"bR" = (
/obj/item/ammo_casing/caseless/fatman,
/turf/open/indestructible,
/area/f13/wasteland)
"cB" = (
/obj/machinery/autolathe/secure,
/turf/open/indestructible,
/area/f13/wasteland)
"cL" = (
/obj/machinery/autolathe,
/turf/open/indestructible,
/area/f13/wasteland)
"ds" = (
/obj/structure/obstacle/barbedwire/end{
	dir = 4
	},
/turf/open/indestructible,
/area/f13/wasteland)
"dJ" = (
/turf/open/indestructible/ground/bl/outside/grass_standard/meadow,
/area/f13/wasteland)
"es" = (
/obj/effect/landmark/start/f13/gmb_commander,
/turf/open/indestructible,
/area/f13/village)
"ew" = (
/obj/effect/landmark/start/f13/hilltop_settler,
/turf/open/indestructible,
/area/f13/village)
"eF" = (
/obj/machinery/autolathe/constructionlathe,
/turf/open/indestructible,
/area/f13/wasteland)
"eO" = (
/obj/item/seeds/bl/milkweed,
/turf/open/indestructible/ground/bl/mud,
/area/f13/wasteland)
"fH" = (
/turf/open/indestructible,
/area/f13/village)
"fN" = (
/obj/item/seeds/bl/licorice,
/turf/open/indestructible/ground/bl/mud,
/area/f13/wasteland)
"gI" = (
/obj/effect/landmark/start/f13/vaultengineer,
/turf/open/indestructible,
/area/f13/village)
"gM" = (
/obj/structure/shieldwall/large/active,
/turf/open/indestructible,
/area/f13/wasteland)
"gX" = (
/obj/structure/billboard/vb/gmtammo,
/turf/open/indestructible,
/area/f13/village)
"hd" = (
/obj/structure/shieldwall/standard/lethal,
/turf/open/indestructible,
/area/f13/wasteland)
"iI" = (
/turf/open/liquid/water,
/area/f13/wasteland)
"iS" = (
/turf/open/indestructible,
/area/f13/wasteland)
"ju" = (
/obj/machinery/autolathe/ammo/unlocked,
/turf/open/indestructible,
/area/f13/wasteland)
"la" = (
/obj/effect/landmark/start/f13/secchief,
/turf/open/indestructible,
/area/f13/village)
"nw" = (
/obj/structure/billboard/vb/glazedholes,
/turf/open/indestructible,
/area/f13/village)
"qA" = (
/obj/effect/landmark/start/f13/gmb_volunteer,
/turf/open/indestructible,
/area/f13/village)
"rH" = (
/obj/machinery/manned_turret/m2,
/turf/open/indestructible,
/area/f13/wasteland)
"rR" = (
/turf/open/liquid/water/deep,
/area/f13/village)
"sd" = (
/obj/effect/landmark/start/f13/dfs_regular,
/turf/open/indestructible,
/area/f13/village)
"tv" = (
/obj/item/storage/box/disks_plantgene,
/turf/open/indestructible,
/area/f13/wasteland)
"tJ" = (
/obj/machinery/chem_master/advanced,
/turf/open/indestructible,
/area/f13/wasteland)
"uM" = (
/turf/open/indestructible/ground/bl/mud,
/area/f13/wasteland)
"uX" = (
/obj/effect/landmark/start/f13/wastelander,
/turf/open/indestructible,
/area/f13/village)
"vO" = (
/turf/open/indestructible/ground/bl/outside/grass_standard/meadow,
/area/f13/village)
"vW" = (
/obj/structure/mineral_door/transparent,
/turf/open/indestructible,
/area/f13/wasteland)
"wq" = (
/obj/machinery/hydroponics/constructable{
	self_sustaining = 1
	},
/turf/open/indestructible,
/area/f13/wasteland)
"wI" = (
/obj/machinery/base_dispenser/enclave,
/turf/open/indestructible,
/area/f13/wasteland)
"wT" = (
/obj/effect/landmark/start/f13/vaultscientist,
/turf/open/indestructible,
/area/f13/village)
"xb" = (
/obj/machinery/base_dispenser/ammo,
/turf/open/indestructible,
/area/f13/wasteland)
"xC" = (
/obj/structure/billboard/vb/lovemybuns,
/turf/open/indestructible,
/area/f13/village)
"yx" = (
/obj/effect/landmark/start/f13/lbj_foreman,
/turf/open/indestructible,
/area/f13/village)
"yE" = (
/obj/effect/landmark/start/f13/dfs_grunt,
/turf/open/indestructible,
/area/f13/village)
"yH" = (
/obj/effect/landmark/start/f13/vaultdoctor,
/turf/open/indestructible,
/area/f13/village)
"zQ" = (
/obj/item/gun/magic/wand/death/debug,
/turf/open/indestructible/ground/bl/outside/grass_standard/meadow,
/area/f13/wasteland)
"Ap" = (
/obj/effect/landmark/start/f13/gmb_militia,
/turf/open/indestructible,
/area/f13/village)
"AL" = (
/turf/closed/indestructible/f13/matrix,
/area/f13/wasteland)
"Be" = (
/obj/machinery/chem_dispenser/fullupgrade,
/turf/open/indestructible,
/area/f13/wasteland)
"BL" = (
/obj/item/gun/magic/wand/resurrection/debug,
/turf/open/indestructible/ground/bl/outside/grass_standard/meadow,
/area/f13/wasteland)
"Cj" = (
/obj/effect/landmark/start/f13/dfs_agent,
/turf/open/indestructible,
/area/f13/village)
"CO" = (
/obj/effect/landmark/latejoin,
/turf/open/indestructible,
/area/f13/village)
"Dg" = (
/obj/effect/landmark/start/f13/overseer,
/turf/open/indestructible,
/area/f13/village)
"DP" = (
/obj/effect/landmark/start/f13/vaultrobot,
/turf/open/indestructible,
/area/f13/village)
"Ea" = (
/obj/machinery/shield_switch,
/turf/open/indestructible,
/area/f13/wasteland)
"EA" = (
/obj/item/seeds/bl/yarrow,
/turf/open/indestructible/ground/bl/mud,
/area/f13/wasteland)
"ET" = (
/obj/structure/billboard/vb/vaulttec,
/turf/open/indestructible,
/area/f13/village)
"Fk" = (
/obj/structure/billboard/vb/oldantucker,
/turf/open/indestructible,
/area/f13/village)
"FE" = (
/obj/item/gun/energy/arcwelder,
/turf/open/indestructible,
/area/f13/wasteland)
"Gc" = (
/obj/machinery/autodoc,
/turf/open/indestructible/ground/bl/outside/grass_standard/meadow,
/area/f13/wasteland)
"Gw" = (
/obj/item/storage/toolbox/mechanical,
/turf/open/indestructible,
/area/f13/wasteland)
"GZ" = (
/obj/structure/billboard/vb/slocumsjoe,
/turf/open/indestructible,
/area/f13/village)
"Hy" = (
/obj/machinery/light/floor,
/turf/open/indestructible,
/area/f13/wasteland)
"Jb" = (
/obj/structure/obstacle/barbedwire{
	dir = 4
	},
/turf/open/indestructible,
/area/f13/wasteland)
"Ku" = (
/obj/effect/landmark/start/f13/gmb_practitioner,
/turf/open/indestructible,
/area/f13/village)
"LL" = (
/obj/machinery/autolathe/ammo/unlocked_basic,
/turf/open/indestructible,
/area/f13/wasteland)
"Ml" = (
/obj/structure/billboard/vb/superdupermart,
/turf/open/indestructible,
/area/f13/village)
"MQ" = (
/obj/structure/obstacle/barbedwire/end{
	dir = 8
	},
/turf/open/indestructible,
/area/f13/wasteland)
"Nc" = (
/obj/item/grenade/f13/mine,
/obj/item/grenade/f13/mine,
/obj/item/grenade/f13/mine,
/obj/item/grenade/f13/mine,
/obj/item/grenade/f13/mine,
/obj/item/grenade/f13/mine,
/turf/open/indestructible,
/area/f13/wasteland)
"Nm" = (
/obj/effect/landmark/start/f13/tavernkeep,
/turf/open/indestructible,
/area/f13/village)
"NA" = (
/obj/structure/shieldwall/standard_owb/active,
/turf/open/indestructible,
/area/f13/wasteland)
"NP" = (
/obj/effect/landmark/start/f13/lbj_lumberjack,
/turf/open/indestructible,
/area/f13/village)
"Oe" = (
/obj/structure/anvil/debugsuper,
/obj/item/melee/smith/hammer/debug,
/turf/open/indestructible,
/area/f13/wasteland)
"Ov" = (
/obj/effect/landmark/start/f13/hilltop_leadership,
/turf/open/indestructible,
/area/f13/village)
"OS" = (
/obj/effect/landmark/start/f13/hilltop_lookout,
/turf/open/indestructible,
/area/f13/village)
"Pa" = (
/obj/machinery/base_dispenser/food,
/turf/open/indestructible,
/area/f13/wasteland)
"PF" = (
/obj/effect/landmark/start/f13/dfs_enforcer,
/turf/open/indestructible,
/area/f13/village)
"Qs" = (
/obj/item/seeds/bl/skullcap,
/turf/open/indestructible/ground/bl/mud,
/area/f13/wasteland)
"Qy" = (
/obj/effect/landmark/start/f13/vaultdweller,
/turf/open/indestructible,
/area/f13/village)
"QO" = (
/obj/machinery/plantgenes,
/turf/open/indestructible,
/area/f13/wasteland)
"Rt" = (
/turf/open/indestructible/ground/bl/outside/gravel,
/area/f13/wasteland)
"RF" = (
/obj/item/melee/bokken/debug,
/turf/open/indestructible/ground/bl/outside/grass_standard/meadow,
/area/f13/wasteland)
"RL" = (
/obj/structure/shieldwall/standard/stun,
/turf/open/indestructible,
/area/f13/wasteland)
"RZ" = (
/obj/effect/landmark/start/f13/engchief,
/turf/open/indestructible,
/area/f13/village)
"Sy" = (
/obj/structure/billboard/vb/readmenace,
/turf/open/indestructible,
/area/f13/village)
"Tp" = (
/obj/structure/mortar/fixed,
/turf/open/indestructible,
/area/f13/wasteland)
"TG" = (
/obj/item/book/granter/trait/holy,
/turf/open/indestructible,
/area/f13/wasteland)
"Vr" = (
/obj/structure/billboard/vb/ratemed,
/turf/open/indestructible,
/area/f13/village)
"Wb" = (
/turf/closed/indestructible/f13/matrix,
/area/f13/village)
"WU" = (
/obj/machinery/autolathe/ammo,
/turf/open/indestructible,
/area/f13/wasteland)
"XM" = (
/turf/open/liquid/water,
/area/f13/village)
"XV" = (
/obj/effect/landmark/start/f13/vaultsecurityofficer,
/turf/open/indestructible,
/area/f13/village)
"Yn" = (
/obj/machinery/autolathe/hacked,
/turf/open/indestructible,
/area/f13/wasteland)
"YN" = (
/obj/structure/closet/crate/mortar_shells,
/turf/open/indestructible,
/area/f13/wasteland)
"Zp" = (
/obj/machinery/porta_turret/f13,
/turf/open/indestructible,
/area/f13/village)
"Zq" = (
/obj/effect/landmark/start/f13/gmb_walker,
/turf/open/indestructible,
/area/f13/village)

(1,1,1) = {"
Wb
Wb
Wb
Wb
Wb
Wb
Wb
Wb
Wb
Wb
Wb
Wb
Wb
Wb
Wb
Wb
Wb
Wb
Wb
Wb
Wb
"}
(2,1,1) = {"
Wb
rR
XM
XM
fH
fH
Wb
Zp
Wb
nw
gX
xC
Fk
Vr
Sy
GZ
Ml
ET
Nm
CO
Wb
"}
(3,1,1) = {"
Wb
rR
XM
XM
fH
fH
Wb
fH
Wb
fH
fH
fH
fH
fH
fH
fH
fH
fH
yH
aa
Wb
"}
(4,1,1) = {"
Wb
rR
XM
iI
Hy
iS
vW
Hy
vW
iS
NA
iS
RL
iS
hd
iS
gM
Hy
Qy
Cj
Wb
"}
(5,1,1) = {"
Wb
rR
XM
iI
cL
Gw
AL
AL
AL
iS
iS
iS
Ea
iS
iS
iS
iS
iS
gI
PF
Wb
"}
(6,1,1) = {"
Wb
rR
XM
iI
WU
iS
iS
iS
iS
iS
iS
iS
QO
iS
iS
iS
iS
iS
DP
yE
Wb
"}
(7,1,1) = {"
Wb
rR
XM
iI
aL
iS
iS
Hy
iS
iS
iS
iS
tv
iS
Hy
iS
iS
iS
wT
sd
Wb
"}
(8,1,1) = {"
Wb
rR
XM
iI
ju
iS
Rt
Rt
wI
Pa
TG
iS
iS
wq
wq
wq
iS
iS
XV
RZ
Wb
"}
(9,1,1) = {"
Wb
rR
XM
iI
LL
iS
Rt
Rt
xb
ds
iS
iS
wq
fN
eO
Qs
wq
iS
uX
es
Wb
"}
(10,1,1) = {"
Wb
rR
XM
iI
eF
iS
Rt
Rt
Rt
Jb
Hy
Hy
iS
uM
uM
EA
iS
iS
fH
Ap
Wb
"}
(11,1,1) = {"
Wb
rR
XM
iI
Yn
iS
Rt
Rt
Rt
Jb
rH
Tp
FE
uM
uM
uM
bj
bR
fH
Ku
Wb
"}
(12,1,1) = {"
Wb
rR
XM
iI
cB
iS
Rt
Rt
Rt
Jb
YN
Nc
iS
uM
uM
uM
bR
bR
fH
qA
Wb
"}
(13,1,1) = {"
Wb
rR
XM
iI
iS
iS
Rt
Rt
Rt
Jb
Hy
Hy
iS
uM
uM
uM
iS
iS
fH
Zq
Wb
"}
(14,1,1) = {"
Wb
rR
XM
iI
iS
iS
Rt
Rt
Be
MQ
iS
iS
wq
uM
uM
uM
wq
iS
fH
Ov
Wb
"}
(15,1,1) = {"
Wb
rR
XM
iI
Oe
iS
Rt
Rt
tJ
iS
iS
iS
iS
wq
wq
wq
iS
iS
fH
OS
Wb
"}
(16,1,1) = {"
Wb
rR
XM
iI
dJ
dJ
dJ
aB
dJ
dJ
dJ
dJ
dJ
dJ
aB
dJ
dJ
iS
fH
ew
Wb
"}
(17,1,1) = {"
Wb
rR
XM
iI
dJ
dJ
dJ
dJ
dJ
dJ
dJ
dJ
dJ
dJ
dJ
dJ
dJ
iS
fH
yx
Wb
"}
(18,1,1) = {"
Wb
rR
XM
iI
Gc
dJ
zQ
BL
dJ
RF
dJ
dJ
dJ
dJ
dJ
dJ
dJ
iS
fH
NP
Wb
"}
(19,1,1) = {"
Wb
rR
XM
iI
aB
dJ
dJ
dJ
dJ
dJ
dJ
dJ
dJ
dJ
dJ
dJ
dJ
Hy
fH
Dg
Wb
"}
(20,1,1) = {"
Wb
rR
XM
XM
vO
vO
vO
vO
vO
vO
vO
vO
vO
vO
vO
vO
vO
fH
fH
la
Wb
"}
(21,1,1) = {"
Wb
rR
XM
XM
vO
vO
vO
vO
vO
vO
vO
vO
vO
vO
vO
vO
vO
fH
fH
fH
Wb
"}
(22,1,1) = {"
Wb
Wb
Wb
Wb
Wb
Wb
Wb
Wb
Wb
Wb
Wb
Wb
Wb
Wb
Wb
Wb
Wb
Wb
Wb
Wb
Wb
"}
